5
10
##-##-####
#-----#--e
##-####-##
#---------
#s###-#-##